111111111111111111111111111111
100000000000000000000000100001
100000010000000000000000100001
100000000000000000000000100001
100000000000000000000000100001
100000000000000000000000100001
100001111111110000000000000001
100000000000010000000000000001
100000000000010000000000000001
100000000000010000000000000001
100000000000010000000000000001
100000000000010000000001000001
100000000000000000000000000001
100000000000000000000000000001
100000000000000000000000000001
100100000000000000000000000001
100000000000000000011111111111
100000000000000000000000000001
100000000000000000000000000001
100000000000000000000000000001
100000000000000000000000000001
100000000000000000000000000001
111111111110000000000010000001
100000000010000000000000000001
100000000010000000000000000001
100000000000000000000000000001
100000000000000000000000000001
100000000010000000000000000001
100000000010000000000000000001
111111111111111111111111111111